"";"atendente";"Bom";"Otimo";"Regular";"QTDE_PESQUISADOS";"RANK"
"6";"FABRÍCIO";14;57;2;73;1
"3";"CLEITON XAVIER";10;58;0;68;2
"13";"MURILO";10;26;1;37;3
"15";"RAQUEL SALES";3;24;1;28;4
"2";" CLEITON XAVIER";5;18;1;24;5
"7";"FERNANDO";6;17;0;23;6
"4";"ELY";0;16;0;16;7
"10";"LUCIA";0;11;0;11;8
"5";"FABRICIO";0;3;1;4;10
"8";"JANUS";2;2;0;4;10
"14";"NAO INFORMADO";0;4;0;4;10
"1";"";0;1;0;1;13,5
"9";"LETICIA MOREIRA";1;0;0;1;13,5
"11";"LUIZA";0;1;0;1;13,5
"12";"LUIZA ";0;1;0;1;13,5
